5 5 4
4 4 3 2 1 
1 1 1 4 1 
1 4 4 4 3 
4 1 4 4 3 
3 2 3 3 4 
